#########################
#A.....##########.#######
##.###.#########..#######
######..#######........##
#####...#...###...####.B#
###.......######..#######
####........#####..######
#........#....####....###
#......#####..........###
##.#...####....##..#..###
#.......###...###########
#.........#....##########
##...................####
#C....#...#...######...E#
#########################
